##########################################
#                                       F#
##################################### ## #
# #                                 #  # #
#   ############################### ## # #
# # #                                # # #
# # # ############################## # # #
# # # #                            ### # #
# # #   ##########################   # # #
# # # # #S                       # #   # #
# # # # #                        # # # # #
# ################# ######################
#                                        #
##########################################
